########################################
########################~~~~############
########################     ###########
########################     ###########
########################      ##########
#########################     ##########
#########################      #########
#########################      #########
#########################      #########
#########################      #########
#########################      #########
#########################      #########
#########################      #########
########################       #########
#######################        #########
###########                    #########
#########                      #########
#########                       ########
##########        ########      ########
##########      ########################
###########     ########################
###########        #####################
############            ################
############                   #########
#############                  **#######
#############                 ##########
##############        ##################
########################################
########################################
########################################
########################################
########################################
########################################
########################################
########################################
########################################
########################################
########################################
########################################
########################################